time_period,time_identifier,geographic_level,country_code,country_name,region_code,region_name,old_la_code,new_la_code,la_name,school_main_phase,count_schools,total_school_places,total_school_pupils_on_roll,SEND_unit_capacity,resourced_provision_capacity,primary_SEND_unit_capacity,primary_resourced_provision_capacity,secondary_SEND_unit_capacity,secondary_resourced_provision_capacity
202223,Academic year,National,E92000001,England,,,,,,Total,1631,1159263,1045588,9010,17820,5912,10213,3098,7607
202223,Academic year,National,E92000001,England,,,,,,Primary,1060,419044,376100,5904,10080,5894,10073,10,7
202223,Academic year,National,E92000001,England,,,,,,Secondary,571,740219,669488,3106,7740,18,140,3088,7600
202223,Academic year,Regional,E92000001,England,E12000001,North East,,,,Total,99,63148,57238,739,1150,482,657,257,493
202223,Academic year,Regional,E92000001,England,E12000001,North East,,,,Primary,64,20120,17490,464,653,464,653,0,0
202223,Academic year,Regional,E92000001,England,E12000001,North East,,,,Secondary,35,43028,39748,275,497,18,4,257,493
202223,Academic year,Local authority,E92000001,England,E12000001,North East,390,E08000037,Gateshead,Total,7,4680,4096,96,8,60,8,36,0
202223,Academic year,Local authority,E92000001,England,E12000001,North East,390,E08000037,Gateshead,Primary,5,1456,1018,60,8,60,8,0,0
202223,Academic year,Local authority,E92000001,England,E12000001,North East,390,E08000037,Gateshead,Secondary,2,3224,3078,36,0,0,0,36,0
202223,Academic year,Local authority,E92000001,England,E12000001,North East,391,E08000021,Newcastle upon Tyne,Total,19,14051,12965,108,207,52,142,56,65
202223,Academic year,Local authority,E92000001,England,E12000001,North East,391,E08000021,Newcastle upon Tyne,Primary,13,4237,3827,52,140,52,140,0,0
202223,Academic year,Local authority,E92000001,England,E12000001,North East,391,E08000021,Newcastle upon Tyne,Secondary,6,9814,9138,56,67,0,2,56,65
202223,Academic year,Local authority,E92000001,England,E12000001,North East,392,E08000022,North Tyneside,Total,11,7730,6964,0,133,0,64,0,69
202223,Academic year,Local authority,E92000001,England,E12000001,North East,392,E08000022,North Tyneside,Primary,5,1219,1073,0,62,0,62,0,0
202223,Academic year,Local authority,E92000001,England,E12000001,North East,392,E08000022,North Tyneside,Secondary,6,6511,5891,0,71,0,2,0,69
202223,Academic year,Local authority,E92000001,England,E12000001,North East,393,E08000023,South Tyneside,Total,6,3491,3445,179,0,103,0,76,0
202223,Academic year,Local authority,E92000001,England,E12000001,North East,393,E08000023,South Tyneside,Primary,4,1050,992,103,0,103,0,0,0
202223,Academic year,Local authority,E92000001,England,E12000001,North East,393,E08000023,South Tyneside,Secondary,2,2441,2453,76,0,0,0,76,0
202223,Academic year,Local authority,E92000001,England,E12000001,North East,394,E08000024,Sunderland,Total,10,6190,5181,185,0,96,0,89,0
202223,Academic year,Local authority,E92000001,England,E12000001,North East,394,E08000024,Sunderland,Primary,6,2170,1852,78,0,78,0,0,0
202223,Academic year,Local authority,E92000001,England,E12000001,North East,394,E08000024,Sunderland,Secondary,4,4020,3329,107,0,18,0,89,0
202223,Academic year,Local authority,E92000001,England,E12000001,North East,805,E06000001,Hartlepool,Total,7,4462,3865,0,167,0,82,0,85
202223,Academic year,Local authority,E92000001,England,E12000001,North East,805,E06000001,Hartlepool,Primary,5,1861,1493,0,82,0,82,0,0
202223,Academic year,Local authority,E92000001,England,E12000001,North East,805,E06000001,Hartlepool,Secondary,2,2601,2372,0,85,0,0,0,85
202223,Academic year,Local authority,E92000001,England,E12000001,North East,806,E06000002,Middlesbrough,Total,11,8269,7641,55,314,55,151,0,163
202223,Academic year,Local authority,E92000001,England,E12000001,North East,806,E06000002,Middlesbrough,Primary,6,2119,1859,55,151,55,151,0,0
202223,Academic year,Local authority,E92000001,England,E12000001,North East,806,E06000002,Middlesbrough,Secondary,5,6150,5782,0,163,0,0,0,163
202223,Academic year,Local authority,E92000001,England,E12000001,North East,807,E06000003,Redcar and Cleveland,Total,6,1625,1399,100,45,100,45,0,0
202223,Academic year,Local authority,E92000001,England,E12000001,North East,807,E06000003,Redcar and Cleveland,Primary,6,1625,1399,100,45,100,45,0,0
202223,Academic year,Local authority,E92000001,England,E12000001,North East,808,E06000004,Stockton-on-Tees,Total,15,9956,9152,0,197,0,112,0,85
202223,Academic year,Local authority,E92000001,England,E12000001,North East,808,E06000004,Stockton-on-Tees,Primary,9,2963,2670,0,112,0,112,0,0
202223,Academic year,Local authority,E92000001,England,E12000001,North East,808,E06000004,Stockton-on-Tees,Secondary,6,6993,6482,0,85,0,0,0,85
202223,Academic year,Local authority,E92000001,England,E12000001,North East,841,E06000005,Darlington,Total,5,1905,1818,16,57,16,43,0,14
202223,Academic year,Local authority,E92000001,England,E12000001,North East,841,E06000005,Darlington,Primary,4,1270,1152,16,43,16,43,0,0
202223,Academic year,Local authority,E92000001,England,E12000001,North East,841,E06000005,Darlington,Secondary,1,635,666,0,14,0,0,0,14
202223,Academic year,Local authority,E92000001,England,E12000001,North East,929,E06000057,Northumberland,Total,2,789,712,0,22,0,10,0,12
202223,Academic year,Local authority,E92000001,England,E12000001,North East,929,E06000057,Northumberland,Primary,1,150,155,0,10,0,10,0,0
202223,Academic year,Local authority,E92000001,England,E12000001,North East,929,E06000057,Northumberland,Secondary,1,639,557,0,12,0,0,0,12
202223,Academic year,Regional,E92000001,England,E12000002,North West,,,,Total,191,109139,102298,654,2056,616,1265,38,791
202223,Academic year,Regional,E92000001,England,E12000002,North West,,,,Primary,136,44362,40564,616,1230,616,1230,0,0
202223,Academic year,Regional,E92000001,England,E12000002,North West,,,,Secondary,55,64777,61734,38,826,0,35,38,791
202223,Academic year,Local authority,E92000001,England,E12000002,North West,341,E08000012,Liverpool,Total,9,2676,2757,184,46,184,46,0,0
202223,Academic year,Local authority,E92000001,England,E12000002,North West,341,E08000012,Liverpool,Primary,9,2676,2757,184,46,184,46,0,0
202223,Academic year,Local authority,E92000001,England,E12000002,North West,342,E08000013,St. Helens,Total,5,2850,2779,0,132,0,52,0,80
202223,Academic year,Local authority,E92000001,England,E12000002,North West,342,E08000013,St. Helens,Primary,3,830,757,0,52,0,52,0,0
202223,Academic year,Local authority,E92000001,England,E12000002,North West,342,E08000013,St. Helens,Secondary,2,2020,2022,0,80,0,0,0,80
202223,Academic year,Local authority,E92000001,England,E12000002,North West,343,E08000014,Sefton,Total,9,3769,3550,207,51,207,10,0,41
202223,Academic year,Local authority,E92000001,England,E12000002,North West,343,E08000014,Sefton,Primary,7,2005,1980,207,10,207,10,0,0
202223,Academic year,Local authority,E92000001,England,E12000002,North West,343,E08000014,Sefton,Secondary,2,1764,1570,0,41,0,0,0,41
202223,Academic year,Local authority,E92000001,England,E12000002,North West,350,E08000001,Bolton,Total,7,3108,2740,0,71,0,46,0,25
202223,Academic year,Local authority,E92000001,England,E12000002,North West,350,E08000001,Bolton,Primary,6,1220,1202,0,46,0,46,0,0
202223,Academic year,Local authority,E92000001,England,E12000002,North West,350,E08000001,Bolton,Secondary,1,1888,1538,0,25,0,0,0,25
202223,Academic year,Local authority,E92000001,England,E12000002,North West,351,E08000002,Bury,Total,5,2217,2249,0,62,0,47,0,15
202223,Academic year,Local authority,E92000001,England,E12000002,North West,351,E08000002,Bury,Primary,4,1167,1143,0,47,0,47,0,0
202223,Academic year,Local authority,E92000001,England,E12000002,North West,351,E08000002,Bury,Secondary,1,1050,1106,0,15,0,0,0,15
202223,Academic year,Local authority,E92000001,England,E12000002,North West,352,E08000003,Manchester,Total,19,13057,12317,0,215,0,144,0,71
202223,Academic year,Local authority,E92000001,England,E12000002,North West,352,E08000003,Manchester,Primary,13,5794,4972,0,130,0,130,0,0
202223,Academic year,Local authority,E92000001,England,E12000002,North West,352,E08000003,Manchester,Secondary,6,7263,7345,0,85,0,14,0,71
202223,Academic year,Local authority,E92000001,England,E12000002,North West,353,E08000004,Oldham,Total,4,3220,3166,0,48,0,24,0,24
202223,Academic year,Local authority,E92000001,England,E12000002,North West,353,E08000004,Oldham,Primary,2,525,516,0,24,0,24,0,0
202223,Academic year,Local authority,E92000001,England,E12000002,North West,353,E08000004,Oldham,Secondary,2,2695,2650,0,24,0,0,0,24
202223,Academic year,Local authority,E92000001,England,E12000002,North West,354,E08000005,Rochdale,Total,4,3360,3323,18,26,18,10,0,16
202223,Academic year,Local authority,E92000001,England,E12000002,North West,354,E08000005,Rochdale,Primary,2,840,811,18,10,18,10,0,0
202223,Academic year,Local authority,E92000001,England,E12000002,North West,354,E08000005,Rochdale,Secondary,2,2520,2512,0,16,0,0,0,16
202223,Academic year,Local authority,E92000001,England,E12000002,North West,355,E08000006,Salford,Total,17,9780,9735,0,270,0,152,0,118
202223,Academic year,Local authority,E92000001,England,E12000002,North West,355,E08000006,Salford,Primary,11,3760,3583,0,152,0,152,0,0
202223,Academic year,Local authority,E92000001,England,E12000002,North West,355,E08000006,Salford,Secondary,6,6020,6152,0,118,0,0,0,118
202223,Academic year,Local authority,E92000001,England,E12000002,North West,356,E08000007,Stockport,Total,13,8125,7406,25,157,25,109,0,48
202223,Academic year,Local authority,E92000001,England,E12000002,North West,356,E08000007,Stockport,Primary,10,3570,3254,25,109,25,109,0,0
202223,Academic year,Local authority,E92000001,England,E12000002,North West,356,E08000007,Stockport,Secondary,3,4555,4152,0,48,0,0,0,48
202223,Academic year,Local authority,E92000001,England,E12000002,North West,357,E08000008,Tameside,Total,9,4236,3862,0,97,0,74,0,23
202223,Academic year,Local authority,E92000001,England,E12000002,North West,357,E08000008,Tameside,Primary,7,2314,1943,0,74,0,74,0,0
202223,Academic year,Local authority,E92000001,England,E12000002,North West,357,E08000008,Tameside,Secondary,2,1922,1919,0,23,0,0,0,23
202223,Academic year,Local authority,E92000001,England,E12000002,North West,358,E08000009,Trafford,Total,8,4029,3638,134,0,100,0,34,0
202223,Academic year,Local authority,E92000001,England,E12000002,North West,358,E08000009,Trafford,Primary,6,1868,1698,100,0,100,0,0,0
202223,Academic year,Local authority,E92000001,England,E12000002,North West,358,E08000009,Trafford,Secondary,2,2161,1940,34,0,0,0,34,0
202223,Academic year,Local authority,E92000001,England,E12000002,North West,359,E08000010,Wigan,Total,8,4307,4255,0,55,0,37,0,18
202223,Academic year,Local authority,E92000001,England,E12000002,North West,359,E08000010,Wigan,Primary,6,2147,2037,0,37,0,37,0,0
202223,Academic year,Local authority,E92000001,England,E12000002,North West,359,E08000010,Wigan,Secondary,2,2160,2218,0,18,0,0,0,18
202223,Academic year,Local authority,E92000001,England,E12000002,North West,876,E06000006,Halton,Total,10,4940,3825,0,145,0,123,0,22
202223,Academic year,Local authority,E92000001,England,E12000002,North West,876,E06000006,Halton,Primary,8,1945,1436,0,102,0,102,0,0
202223,Academic year,Local authority,E92000001,England,E12000002,North West,876,E06000006,Halton,Secondary,2,2995,2389,0,43,0,21,0,22
202223,Academic year,Local authority,E92000001,England,E12000002,North West,877,E06000007,Warrington,Total,11,6979,6991,0,199,0,114,0,85
202223,Academic year,Local authority,E92000001,England,E12000002,North West,877,E06000007,Warrington,Primary,6,1890,1879,0,114,0,114,0,0
202223,Academic year,Local authority,E92000001,England,E12000002,North West,877,E06000007,Warrington,Secondary,5,5089,5112,0,85,0,0,0,85
202223,Academic year,Local authority,E92000001,England,E12000002,North West,889,E06000008,Blackburn with Darwen,Total,3,2260,2099,30,0,26,0,4,0
202223,Academic year,Local authority,E92000001,England,E12000002,North West,889,E06000008,Blackburn with Darwen,Primary,2,630,598,26,0,26,0,0,0
202223,Academic year,Local authority,E92000001,England,E12000002,North West,889,E06000008,Blackburn with Darwen,Secondary,1,1630,1501,4,0,0,0,4,0
202223,Academic year,Local authority,E92000001,England,E12000002,North West,890,E06000009,Blackpool,Total,3,1290,1062,48,12,48,12,0,0
202223,Academic year,Local authority,E92000001,England,E12000002,North West,890,E06000009,Blackpool,Primary,3,1290,1062,48,12,48,12,0,0
202223,Academic year,Local authority,E92000001,England,E12000002,North West,895,E06000049,Cheshire East,Total,16,9390,9005,8,166,8,96,0,70
202223,Academic year,Local authority,E92000001,England,E12000002,North West,895,E06000049,Cheshire East,Primary,12,4725,4242,8,96,8,96,0,0
202223,Academic year,Local authority,E92000001,England,E12000002,North West,895,E06000049,Cheshire East,Secondary,4,4665,4763,0,70,0,0,0,70
202223,Academic year,Local authority,E92000001,England,E12000002,North West,896,E06000050,Cheshire West and Chester,Total,11,4993,4506,0,114,0,87,0,27
202223,Academic year,Local authority,E92000001,England,E12000002,North West,896,E06000050,Cheshire West and Chester,Primary,9,2677,2469,0,87,0,87,0,0
202223,Academic year,Local authority,E92000001,England,E12000002,North West,896,E06000050,Cheshire West and Chester,Secondary,2,2316,2037,0,27,0,0,0,27
202223,Academic year,Local authority,E92000001,England,E12000002,North West,942,E06000063,Cumberland,Total,12,9328,8896,0,112,0,49,0,63
202223,Academic year,Local authority,E92000001,England,E12000002,North West,942,E06000063,Cumberland,Primary,6,1253,1227,0,49,0,49,0,0
202223,Academic year,Local authority,E92000001,England,E12000002,North West,942,E06000063,Cumberland,Secondary,6,8075,7669,0,63,0,0,0,63
202223,Academic year,Local authority,E92000001,England,E12000002,North West,943,E06000064,Westmorland and Furness,Total,8,5225,4137,0,78,0,33,0,45
202223,Academic year,Local authority,E92000001,England,E12000002,North West,943,E06000064,Westmorland and Furness,Primary,4,1236,998,0,33,0,33,0,0
202223,Academic year,Local authority,E92000001,England,E12000002,North West,943,E06000064,Westmorland and Furness,Secondary,4,3989,3139,0,45,0,0,0,45
202223,Academic year,Regional,E92000001,England,E12000003,Yorkshire and The Humber,,,,Total,149,116116,104209,302,1868,144,1000,158,868
202223,Academic year,Regional,E92000001,England,E12000003,Yorkshire and The Humber,,,,Primary,86,30663,27752,144,994,144,994,0,0
202223,Academic year,Regional,E92000001,England,E12000003,Yorkshire and The Humber,,,,Secondary,63,85453,76457,158,874,0,6,158,868
202223,Academic year,Local authority,E92000001,England,E12000003,Yorkshire and The Humber,370,E08000016,Barnsley,Total,8,5695,5519,44,131,28,45,16,86
202223,Academic year,Local authority,E92000001,England,E12000003,Yorkshire and The Humber,370,E08000016,Barnsley,Primary,5,1575,1417,28,45,28,45,0,0
202223,Academic year,Local authority,E92000001,England,E12000003,Yorkshire and The Humber,370,E08000016,Barnsley,Secondary,3,4120,4102,16,86,0,0,16,86
202223,Academic year,Local authority,E92000001,England,E12000003,Yorkshire and The Humber,372,E08000018,Rotherham,Total,9,8782,7783,0,95,0,40,0,55
202223,Academic year,Local authority,E92000001,England,E12000003,Yorkshire and The Humber,372,E08000018,Rotherham,Primary,5,1678,1385,0,40,0,40,0,0
202223,Academic year,Local authority,E92000001,England,E12000003,Yorkshire and The Humber,372,E08000018,Rotherham,Secondary,4,7104,6398,0,55,0,0,0,55
202223,Academic year,Local authority,E92000001,England,E12000003,Yorkshire and The Humber,373,E08000019,Sheffield,Total,25,17416,17277,0,355,0,238,0,117
202223,Academic year,Local authority,E92000001,England,E12000003,Yorkshire and The Humber,373,E08000019,Sheffield,Primary,17,6337,5942,0,238,0,238,0,0
202223,Academic year,Local authority,E92000001,England,E12000003,Yorkshire and The Humber,373,E08000019,Sheffield,Secondary,8,11079,11335,0,117,0,0,0,117
202223,Academic year,Local authority,E92000001,England,E12000003,Yorkshire and The Humber,380,E08000032,Bradford,Total,32,24533,23128,0,553,0,308,0,245
202223,Academic year,Local authority,E92000001,England,E12000003,Yorkshire and The Humber,380,E08000032,Bradford,Primary,21,8205,7649,0,308,0,308,0,0
202223,Academic year,Local authority,E92000001,England,E12000003,Yorkshire and The Humber,380,E08000032,Bradford,Secondary,11,16328,15479,0,245,0,0,0,245
202223,Academic year,Local authority,E92000001,England,E12000003,Yorkshire and The Humber,381,E08000033,Calderdale,Total,7,2647,1992,40,40,40,30,0,10
202223,Academic year,Local authority,E92000001,England,E12000003,Yorkshire and The Humber,381,E08000033,Calderdale,Primary,6,1447,1084,40,30,40,30,0,0
202223,Academic year,Local authority,E92000001,England,E12000003,Yorkshire and The Humber,381,E08000033,Calderdale,Secondary,1,1200,908,0,10,0,0,0,10
202223,Academic year,Local authority,E92000001,England,E12000003,Yorkshire and The Humber,382,E08000034,Kirklees,Total,8,6515,6236,148,0,40,0,108,0
202223,Academic year,Local authority,E92000001,England,E12000003,Yorkshire and The Humber,382,E08000034,Kirklees,Primary,3,1120,1092,40,0,40,0,0,0
202223,Academic year,Local authority,E92000001,England,E12000003,Yorkshire and The Humber,382,E08000034,Kirklees,Secondary,5,5395,5144,108,0,0,0,108,0
202223,Academic year,Local authority,E92000001,England,E12000003,Yorkshire and The Humber,383,E08000035,Leeds,Total,19,18478,16189,0,236,0,128,0,108
202223,Academic year,Local authority,E92000001,England,E12000003,Yorkshire and The Humber,383,E08000035,Leeds,Primary,9,4038,3683,0,122,0,122,0,0
202223,Academic year,Local authority,E92000001,England,E12000003,Yorkshire and The Humber,383,E08000035,Leeds,Secondary,10,14440,12506,0,114,0,6,0,108
202223,Academic year,Local authority,E92000001,England,E12000003,Yorkshire and The Humber,384,E08000036,Wakefield,Total,11,9005,8207,0,196,0,93,0,103
202223,Academic year,Local authority,E92000001,England,E12000003,Yorkshire and The Humber,384,E08000036,Wakefield,Primary,5,1470,1393,0,93,0,93,0,0
202223,Academic year,Local authority,E92000001,England,E12000003,Yorkshire and The Humber,384,E08000036,Wakefield,Secondary,6,7535,6814,0,103,0,0,0,103
202223,Academic year,Local authority,E92000001,England,E12000003,Yorkshire and The Humber,811,E06000011,East Riding of Yorkshire,Total,13,12652,9543,18,142,0,42,18,100
202223,Academic year,Local authority,E92000001,England,E12000003,Yorkshire and The Humber,811,E06000011,East Riding of Yorkshire,Primary,5,1989,1793,0,42,0,42,0,0
202223,Academic year,Local authority,E92000001,England,E12000003,Yorkshire and The Humber,811,E06000011,East Riding of Yorkshire,Secondary,8,10663,7750,18,100,0,0,18,100
202223,Academic year,Local authority,E92000001,England,E12000003,Yorkshire and The Humber,812,E06000012,North East Lincolnshire,Total,3,735,637,36,0,36,0,0,0
202223,Academic year,Local authority,E92000001,England,E12000003,Yorkshire and The Humber,812,E06000012,North East Lincolnshire,Primary,3,735,637,36,0,36,0,0,0
202223,Academic year,Local authority,E92000001,England,E12000003,Yorkshire and The Humber,815,E06000065,North Yorkshire,Total,10,5974,4232,16,64,0,40,16,24
202223,Academic year,Local authority,E92000001,England,E12000003,Yorkshire and The Humber,815,E06000065,North Yorkshire,Primary,5,1452,1141,0,40,0,40,0,0
202223,Academic year,Local authority,E92000001,England,E12000003,Yorkshire and The Humber,815,E06000065,North Yorkshire,Secondary,5,4522,3091,16,24,0,0,16,24
202223,Academic year,Local authority,E92000001,England,E12000003,Yorkshire and The Humber,816,E06000014,York,Total,4,3684,3466,0,56,0,36,0,20
202223,Academic year,Local authority,E92000001,England,E12000003,Yorkshire and The Humber,816,E06000014,York,Primary,2,617,536,0,36,0,36,0,0
202223,Academic year,Local authority,E92000001,England,E12000003,Yorkshire and The Humber,816,E06000014,York,Secondary,2,3067,2930,0,20,0,0,0,20
202223,Academic year,Regional,E92000001,England,E12000004,East Midlands,,,,Total,87,58150,53700,1459,107,892,18,567,89
202223,Academic year,Regional,E92000001,England,E12000004,East Midlands,,,,Primary,57,20982,18955,892,18,892,18,0,0
202223,Academic year,Regional,E92000001,England,E12000004,East Midlands,,,,Secondary,30,37168,34745,567,89,0,0,567,89
202223,Academic year,Local authority,E92000001,England,E12000004,East Midlands,830,E10000007,Derbyshire,Total,18,9927,8926,262,0,109,0,153,0
202223,Academic year,Local authority,E92000001,England,E12000004,East Midlands,830,E10000007,Derbyshire,Primary,11,3026,2432,109,0,109,0,0,0
202223,Academic year,Local authority,E92000001,England,E12000004,East Midlands,830,E10000007,Derbyshire,Secondary,7,6901,6494,153,0,0,0,153,0
202223,Academic year,Local authority,E92000001,England,E12000004,East Midlands,855,E10000018,Leicestershire,Total,25,16609,14813,490,0,293,0,197,0
202223,Academic year,Local authority,E92000001,England,E12000004,East Midlands,855,E10000018,Leicestershire,Primary,17,5976,5380,293,0,293,0,0,0
202223,Academic year,Local authority,E92000001,England,E12000004,East Midlands,855,E10000018,Leicestershire,Secondary,8,10633,9433,197,0,0,0,197,0
202223,Academic year,Local authority,E92000001,England,E12000004,East Midlands,856,E06000016,Leicester,Total,16,10243,9802,230,0,145,0,85,0
202223,Academic year,Local authority,E92000001,England,E12000004,East Midlands,856,E06000016,Leicester,Primary,12,4943,4657,145,0,145,0,0,0
202223,Academic year,Local authority,E92000001,England,E12000004,East Midlands,856,E06000016,Leicester,Secondary,4,5300,5145,85,0,0,0,85,0
202223,Academic year,Local authority,E92000001,England,E12000004,East Midlands,857,E06000017,Rutland,Total,3,2310,2216,20,35,20,0,0,35
202223,Academic year,Local authority,E92000001,England,E12000004,East Midlands,857,E06000017,Rutland,Primary,1,315,244,20,0,20,0,0,0
202223,Academic year,Local authority,E92000001,England,E12000004,East Midlands,857,E06000017,Rutland,Secondary,2,1995,1972,0,35,0,0,0,35
202223,Academic year,Local authority,E92000001,England,E12000004,East Midlands,892,E06000018,Nottingham,Total,6,5770,5447,0,72,0,18,0,54
202223,Academic year,Local authority,E92000001,England,E12000004,East Midlands,892,E06000018,Nottingham,Primary,2,840,838,0,18,0,18,0,0
202223,Academic year,Local authority,E92000001,England,E12000004,East Midlands,892,E06000018,Nottingham,Secondary,4,4930,4609,0,54,0,0,0,54
202223,Academic year,Local authority,E92000001,England,E12000004,East Midlands,940,E06000061,North Northamptonshire,Total,7,4834,4666,199,0,108,0,91,0
202223,Academic year,Local authority,E92000001,England,E12000004,East Midlands,940,E06000061,North Northamptonshire,Primary,5,2282,2283,108,0,108,0,0,0
202223,Academic year,Local authority,E92000001,England,E12000004,East Midlands,940,E06000061,North Northamptonshire,Secondary,2,2552,2383,91,0,0,0,91,0
202223,Academic year,Local authority,E92000001,England,E12000004,East Midlands,941,E06000062,West Northamptonshire,Total,12,8457,7830,258,0,217,0,41,0
202223,Academic year,Local authority,E92000001,England,E12000004,East Midlands,941,E06000062,West Northamptonshire,Primary,9,3600,3121,217,0,217,0,0,0
202223,Academic year,Local authority,E92000001,England,E12000004,East Midlands,941,E06000062,West Northamptonshire,Secondary,3,4857,4709,41,0,0,0,41,0
202223,Academic year,Regional,E92000001,England,E12000005,West Midlands,,,,Total,141,91805,82757,356,1600,271,944,85,656
202223,Academic year,Regional,E92000001,England,E12000005,West Midlands,,,,Primary,96,37719,35813,278,931,271,924,7,7
202223,Academic year,Regional,E92000001,England,E12000005,West Midlands,,,,Secondary,45,54086,46944,78,669,0,20,78,649
202223,Academic year,Local authority,E92000001,England,E12000005,West Midlands,330,E08000025,Birmingham,Total,43,30298,28661,0,655,0,370,0,285
202223,Academic year,Local authority,E92000001,England,E12000005,West Midlands,330,E08000025,Birmingham,Primary,29,12833,12618,0,358,0,358,0,0
202223,Academic year,Local authority,E92000001,England,E12000005,West Midlands,330,E08000025,Birmingham,Secondary,14,17465,16043,0,297,0,12,0,285
202223,Academic year,Local authority,E92000001,England,E12000005,West Midlands,331,E08000026,Coventry,Total,7,4931,4905,0,84,0,72,0,12
202223,Academic year,Local authority,E92000001,England,E12000005,West Midlands,331,E08000026,Coventry,Primary,5,2205,2088,0,72,0,72,0,0
202223,Academic year,Local authority,E92000001,England,E12000005,West Midlands,331,E08000026,Coventry,Secondary,2,2726,2817,0,12,0,0,0,12
202223,Academic year,Local authority,E92000001,England,E12000005,West Midlands,332,E08000027,Dudley,Total,7,3915,3543,32,66,32,44,0,22
202223,Academic year,Local authority,E92000001,England,E12000005,West Midlands,332,E08000027,Dudley,Primary,5,1655,1523,32,44,32,44,0,0
202223,Academic year,Local authority,E92000001,England,E12000005,West Midlands,332,E08000027,Dudley,Secondary,2,2260,2020,0,22,0,0,0,22
202223,Academic year,Local authority,E92000001,England,E12000005,West Midlands,333,E08000028,Sandwell,Total,14,8216,7933,20,167,20,97,0,70
202223,Academic year,Local authority,E92000001,England,E12000005,West Midlands,333,E08000028,Sandwell,Primary,11,4717,4507,20,97,20,97,0,0
202223,Academic year,Local authority,E92000001,England,E12000005,West Midlands,333,E08000028,Sandwell,Secondary,3,3499,3426,0,70,0,0,0,70
202223,Academic year,Local authority,E92000001,England,E12000005,West Midlands,334,E08000029,Solihull,Total,5,3434,3687,0,116,0,36,0,80
202223,Academic year,Local authority,E92000001,England,E12000005,West Midlands,334,E08000029,Solihull,Primary,3,1048,1061,0,36,0,36,0,0
202223,Academic year,Local authority,E92000001,England,E12000005,West Midlands,334,E08000029,Solihull,Secondary,2,2386,2626,0,80,0,0,0,80
202223,Academic year,Local authority,E92000001,England,E12000005,West Midlands,335,E08000030,Walsall,Total,9,6006,5711,0,98,0,67,0,31
202223,Academic year,Local authority,E92000001,England,E12000005,West Midlands,335,E08000030,Walsall,Primary,6,2100,2034,0,67,0,67,0,0
202223,Academic year,Local authority,E92000001,England,E12000005,West Midlands,335,E08000030,Walsall,Secondary,3,3906,3677,0,31,0,0,0,31
202223,Academic year,Local authority,E92000001,England,E12000005,West Midlands,336,E08000031,Wolverhampton,Total,9,4907,4474,16,124,16,86,0,38
202223,Academic year,Local authority,E92000001,England,E12000005,West Midlands,336,E08000031,Wolverhampton,Primary,6,1730,1684,16,86,16,86,0,0
202223,Academic year,Local authority,E92000001,England,E12000005,West Midlands,336,E08000031,Wolverhampton,Secondary,3,3177,2790,0,38,0,0,0,38
202223,Academic year,Local authority,E92000001,England,E12000005,West Midlands,860,E10000028,Staffordshire,Total,7,5732,4110,20,41,20,16,0,25
202223,Academic year,Local authority,E92000001,England,E12000005,West Midlands,860,E10000028,Staffordshire,Primary,3,1050,968,20,16,20,16,0,0
202223,Academic year,Local authority,E92000001,England,E12000005,West Midlands,860,E10000028,Staffordshire,Secondary,4,4682,3142,0,25,0,0,0,25
202223,Academic year,Local authority,E92000001,England,E12000005,West Midlands,861,E06000021,Stoke-on-Trent,Total,4,1896,1907,65,12,65,12,0,0
202223,Academic year,Local authority,E92000001,England,E12000005,West Midlands,861,E06000021,Stoke-on-Trent,Primary,4,1896,1907,65,12,65,12,0,0
202223,Academic year,Local authority,E92000001,England,E12000005,West Midlands,884,E06000019,"Herefordshire, County of",Total,2,1385,1316,40,0,32,0,8,0
202223,Academic year,Local authority,E92000001,England,E12000005,West Midlands,884,E06000019,"Herefordshire, County of",Primary,1,210,266,32,0,32,0,0,0
202223,Academic year,Local authority,E92000001,England,E12000005,West Midlands,884,E06000019,"Herefordshire, County of",Secondary,1,1175,1050,8,0,0,0,8,0
202223,Academic year,Local authority,E92000001,England,E12000005,West Midlands,885,E10000034,Worcestershire,Total,18,12931,10308,147,97,70,32,77,65
202223,Academic year,Local authority,E92000001,England,E12000005,West Midlands,885,E10000034,Worcestershire,Primary,9,2870,2528,77,31,70,24,7,7
202223,Academic year,Local authority,E92000001,England,E12000005,West Midlands,885,E10000034,Worcestershire,Secondary,9,10061,7780,70,66,0,8,70,58
202223,Academic year,Local authority,E92000001,England,E12000005,West Midlands,894,E06000020,Telford and Wrekin,Total,3,1250,1141,16,4,16,4,0,0
202223,Academic year,Local authority,E92000001,England,E12000005,West Midlands,894,E06000020,Telford and Wrekin,Primary,3,1250,1141,16,4,16,4,0,0
202223,Academic year,Local authority,E92000001,England,E12000005,West Midlands,937,E10000031,Warwickshire,Total,13,6904,5061,0,136,0,108,0,28
202223,Academic year,Local authority,E92000001,England,E12000005,West Midlands,937,E10000031,Warwickshire,Primary,11,4155,3488,0,108,0,108,0,0
202223,Academic year,Local authority,E92000001,England,E12000005,West Midlands,937,E10000031,Warwickshire,Secondary,2,2749,1573,0,28,0,0,0,28
202223,Academic year,Regional,E92000001,England,E12000006,East of England,,,,Total,168,117066,104890,1562,863,1079,310,483,553
202223,Academic year,Regional,E92000001,England,E12000006,East of England,,,,Primary,109,43284,39023,1082,310,1079,310,3,0
202223,Academic year,Regional,E92000001,England,E12000006,East of England,,,,Secondary,59,73782,65867,480,553,0,0,480,553
202223,Academic year,Local authority,E92000001,England,E12000006,East of England,821,E06000032,Luton,Total,8,8380,7901,117,0,63,0,54,0
202223,Academic year,Local authority,E92000001,England,E12000006,East of England,821,E06000032,Luton,Primary,4,2730,2661,63,0,63,0,0,0
202223,Academic year,Local authority,E92000001,England,E12000006,East of England,821,E06000032,Luton,Secondary,4,5650,5240,54,0,0,0,54,0
202223,Academic year,Local authority,E92000001,England,E12000006,East of England,822,E06000055,Bedford,Total,5,4589,4315,0,90,0,20,0,70
202223,Academic year,Local authority,E92000001,England,E12000006,East of England,822,E06000055,Bedford,Primary,2,1470,1231,0,20,0,20,0,0
202223,Academic year,Local authority,E92000001,England,E12000006,East of England,822,E06000055,Bedford,Secondary,3,3119,3084,0,70,0,0,0,70
202223,Academic year,Local authority,E92000001,England,E12000006,East of England,823,E06000056,Central Bedfordshire,Total,8,5112,5012,47,0,30,0,17,0
202223,Academic year,Local authority,E92000001,England,E12000006,East of England,823,E06000056,Central Bedfordshire,Primary,5,2340,2206,33,0,30,0,3,0
202223,Academic year,Local authority,E92000001,England,E12000006,East of England,823,E06000056,Central Bedfordshire,Secondary,3,2772,2806,14,0,0,0,14,0
202223,Academic year,Local authority,E92000001,England,E12000006,East of England,873,E10000003,Cambridgeshire,Total,13,12575,10985,9,222,9,25,0,197
202223,Academic year,Local authority,E92000001,England,E12000006,East of England,873,E10000003,Cambridgeshire,Primary,4,1620,1145,9,25,9,25,0,0
202223,Academic year,Local authority,E92000001,England,E12000006,East of England,873,E10000003,Cambridgeshire,Secondary,9,10955,9840,0,197,0,0,0,197
202223,Academic year,Local authority,E92000001,England,E12000006,East of England,874,E06000031,Peterborough,Total,8,7002,6478,0,55,0,27,0,28
202223,Academic year,Local authority,E92000001,England,E12000006,East of England,874,E06000031,Peterborough,Primary,4,1575,1364,0,27,0,27,0,0
202223,Academic year,Local authority,E92000001,England,E12000006,East of England,874,E06000031,Peterborough,Secondary,4,5427,5114,0,28,0,0,0,28
202223,Academic year,Local authority,E92000001,England,E12000006,East of England,881,E10000012,Essex,Total,26,21329,19617,35,389,20,199,15,190
202223,Academic year,Local authority,E92000001,England,E12000006,East of England,881,E10000012,Essex,Primary,15,5517,5045,20,199,20,199,0,0
202223,Academic year,Local authority,E92000001,England,E12000006,East of England,881,E10000012,Essex,Secondary,11,15812,14572,15,190,0,0,15,190
202223,Academic year,Local authority,E92000001,England,E12000006,East of England,882,E06000033,Southend-on-Sea,Total,9,8698,8367,102,0,62,0,40,0
202223,Academic year,Local authority,E92000001,England,E12000006,East of England,882,E06000033,Southend-on-Sea,Primary,5,2940,2689,62,0,62,0,0,0
202223,Academic year,Local authority,E92000001,England,E12000006,East of England,882,E06000033,Southend-on-Sea,Secondary,4,5758,5678,40,0,0,0,40,0
202223,Academic year,Local authority,E92000001,England,E12000006,East of England,883,E06000034,Thurrock,Total,13,9333,8819,176,0,109,0,67,0
202223,Academic year,Local authority,E92000001,England,E12000006,East of England,883,E06000034,Thurrock,Primary,10,5490,5291,109,0,109,0,0,0
202223,Academic year,Local authority,E92000001,England,E12000006,East of England,883,E06000034,Thurrock,Secondary,3,3843,3528,67,0,0,0,67,0
202223,Academic year,Local authority,E92000001,England,E12000006,East of England,919,E10000015,Hertfordshire,Total,17,8632,7782,166,20,138,0,28,20
202223,Academic year,Local authority,E92000001,England,E12000006,East of England,919,E10000015,Hertfordshire,Primary,14,4711,4343,138,0,138,0,0,0
202223,Academic year,Local authority,E92000001,England,E12000006,East of England,919,E10000015,Hertfordshire,Secondary,3,3921,3439,28,20,0,0,28,20
202223,Academic year,Local authority,E92000001,England,E12000006,East of England,926,E10000020,Norfolk,Total,34,14631,11243,426,0,326,0,100,0
202223,Academic year,Local authority,E92000001,England,E12000006,East of England,926,E10000020,Norfolk,Primary,29,8423,7201,326,0,326,0,0,0
202223,Academic year,Local authority,E92000001,England,E12000006,East of England,926,E10000020,Norfolk,Secondary,5,6208,4042,100,0,0,0,100,0
202223,Academic year,Local authority,E92000001,England,E12000006,East of England,935,E10000029,Suffolk,Total,27,16785,14371,484,87,322,39,162,48
202223,Academic year,Local authority,E92000001,England,E12000006,East of England,935,E10000029,Suffolk,Primary,17,6468,5847,322,39,322,39,0,0
202223,Academic year,Local authority,E92000001,England,E12000006,East of England,935,E10000029,Suffolk,Secondary,10,10317,8524,162,48,0,0,162,48
202223,Academic year,Regional,E92000001,England,E12000007,London,,,,Total,318,261729,232987,1506,4476,1039,2874,467,1602
202223,Academic year,Regional,E92000001,England,E12000007,London,,,,Primary,215,109200,94419,1039,2825,1039,2825,0,0
202223,Academic year,Regional,E92000001,England,E12000007,London,,,,Secondary,103,152529,138568,467,1651,0,49,467,1602
202223,Academic year,Regional,E92000001,England,E12000008,South East,,,,Total,334,241007,219536,1318,4479,813,2351,505,2128
202223,Academic year,Regional,E92000001,England,E12000008,South East,,,,Primary,209,80234,73617,813,2351,813,2351,0,0
202223,Academic year,Regional,E92000001,England,E12000008,South East,,,,Secondary,125,160773,145919,505,2128,0,0,505,2128
202223,Academic year,Local authority,E92000001,England,E12000008,South East,825,E06000060,Buckinghamshire,Total,21,13635,11862,8,254,0,154,8,100
202223,Academic year,Local authority,E92000001,England,E12000008,South East,825,E06000060,Buckinghamshire,Primary,14,5428,5272,0,154,0,154,0,0
202223,Academic year,Local authority,E92000001,England,E12000008,South East,825,E06000060,Buckinghamshire,Secondary,7,8207,6590,8,100,0,0,8,100
202223,Academic year,Local authority,E92000001,England,E12000008,South East,826,E06000042,Milton Keynes,Total,8,5189,5195,33,102,33,21,0,81
202223,Academic year,Local authority,E92000001,England,E12000008,South East,826,E06000042,Milton Keynes,Primary,6,2220,2118,33,21,33,21,0,0
202223,Academic year,Local authority,E92000001,England,E12000008,South East,826,E06000042,Milton Keynes,Secondary,2,2969,3077,0,81,0,0,0,81
202223,Academic year,Local authority,E92000001,England,E12000008,South East,845,E10000011,East Sussex,Total,17,15995,14534,0,185,0,63,0,122
202223,Academic year,Local authority,E92000001,England,E12000008,South East,845,E10000011,East Sussex,Primary,7,2730,2518,0,63,0,63,0,0
202223,Academic year,Local authority,E92000001,England,E12000008,South East,845,E10000011,East Sussex,Secondary,10,13265,12016,0,122,0,0,0,122
202223,Academic year,Local authority,E92000001,England,E12000008,South East,846,E06000043,Brighton and Hove,Total,6,5312,3719,40,86,40,30,0,56
202223,Academic year,Local authority,E92000001,England,E12000008,South East,846,E06000043,Brighton and Hove,Primary,3,1257,895,40,30,40,30,0,0
202223,Academic year,Local authority,E92000001,England,E12000008,South East,846,E06000043,Brighton and Hove,Secondary,3,4055,2824,0,56,0,0,0,56
202223,Academic year,Local authority,E92000001,England,E12000008,South East,850,E10000014,Hampshire,Total,46,28904,26868,0,630,0,367,0,263
202223,Academic year,Local authority,E92000001,England,E12000008,South East,850,E10000014,Hampshire,Primary,27,8115,7626,0,367,0,367,0,0
202223,Academic year,Local authority,E92000001,England,E12000008,South East,850,E10000014,Hampshire,Secondary,19,20789,19242,0,263,0,0,0,263
202223,Academic year,Local authority,E92000001,England,E12000008,South East,851,E06000044,Portsmouth,Total,11,6050,5873,145,28,121,4,24,24
202223,Academic year,Local authority,E92000001,England,E12000008,South East,851,E06000044,Portsmouth,Primary,8,2700,2600,121,4,121,4,0,0
202223,Academic year,Local authority,E92000001,England,E12000008,South East,851,E06000044,Portsmouth,Secondary,3,3350,3273,24,24,0,0,24,24
202223,Academic year,Local authority,E92000001,England,E12000008,South East,852,E06000045,Southampton,Total,2,1470,1478,0,21,0,14,0,7
202223,Academic year,Local authority,E92000001,England,E12000008,South East,852,E06000045,Southampton,Primary,1,420,407,0,14,0,14,0,0
202223,Academic year,Local authority,E92000001,England,E12000008,South East,852,E06000045,Southampton,Secondary,1,1050,1071,0,7,0,0,0,7
202223,Academic year,Local authority,E92000001,England,E12000008,South East,867,E06000036,Bracknell Forest,Total,7,5206,4124,64,80,8,80,56,0
202223,Academic year,Local authority,E92000001,England,E12000008,South East,867,E06000036,Bracknell Forest,Primary,6,3300,2657,8,80,8,80,0,0
202223,Academic year,Local authority,E92000001,England,E12000008,South East,867,E06000036,Bracknell Forest,Secondary,1,1906,1467,56,0,0,0,56,0
202223,Academic year,Local authority,E92000001,England,E12000008,South East,868,E06000040,Windsor and Maidenhead,Total,8,5793,5315,0,69,0,37,0,32
202223,Academic year,Local authority,E92000001,England,E12000008,South East,868,E06000040,Windsor and Maidenhead,Primary,5,1620,1550,0,37,0,37,0,0
202223,Academic year,Local authority,E92000001,England,E12000008,South East,868,E06000040,Windsor and Maidenhead,Secondary,3,4173,3765,0,32,0,0,0,32
202223,Academic year,Local authority,E92000001,England,E12000008,South East,869,E06000037,West Berkshire,Total,9,6276,5481,0,144,0,53,0,91
202223,Academic year,Local authority,E92000001,England,E12000008,South East,869,E06000037,West Berkshire,Primary,6,1710,1673,0,53,0,53,0,0
202223,Academic year,Local authority,E92000001,England,E12000008,South East,869,E06000037,West Berkshire,Secondary,3,4566,3808,0,91,0,0,0,91
202223,Academic year,Local authority,E92000001,England,E12000008,South East,870,E06000038,Reading,Total,6,5427,4917,57,98,0,41,57,57
202223,Academic year,Local authority,E92000001,England,E12000008,South East,870,E06000038,Reading,Primary,3,1365,1275,0,41,0,41,0,0
202223,Academic year,Local authority,E92000001,England,E12000008,South East,870,E06000038,Reading,Secondary,3,4062,3642,57,57,0,0,57,57
202223,Academic year,Local authority,E92000001,England,E12000008,South East,871,E06000039,Slough,Total,12,11095,9588,0,279,0,167,0,112
202223,Academic year,Local authority,E92000001,England,E12000008,South East,871,E06000039,Slough,Primary,6,2932,2716,0,167,0,167,0,0
202223,Academic year,Local authority,E92000001,England,E12000008,South East,871,E06000039,Slough,Secondary,6,8163,6872,0,112,0,0,0,112
202223,Academic year,Local authority,E92000001,England,E12000008,South East,872,E06000041,Wokingham,Total,9,4916,5001,0,82,0,57,0,25
202223,Academic year,Local authority,E92000001,England,E12000008,South East,872,E06000041,Wokingham,Primary,7,1789,1747,0,57,0,57,0,0
202223,Academic year,Local authority,E92000001,England,E12000008,South East,872,E06000041,Wokingham,Secondary,2,3127,3254,0,25,0,0,0,25
202223,Academic year,Local authority,E92000001,England,E12000008,South East,886,E10000016,Kent,Total,65,45570,42628,0,1462,0,763,0,699
202223,Academic year,Local authority,E92000001,England,E12000008,South East,886,E10000016,Kent,Primary,41,17229,15909,0,763,0,763,0,0
202223,Academic year,Local authority,E92000001,England,E12000008,South East,886,E10000016,Kent,Secondary,24,28341,26719,0,699,0,0,0,699
202223,Academic year,Local authority,E92000001,England,E12000008,South East,887,E06000035,Medway,Total,12,10389,9055,8,365,8,192,0,173
202223,Academic year,Local authority,E92000001,England,E12000008,South East,887,E06000035,Medway,Primary,7,3092,2472,8,192,8,192,0,0
202223,Academic year,Local authority,E92000001,England,E12000008,South East,887,E06000035,Medway,Secondary,5,7297,6583,0,173,0,0,0,173
202223,Academic year,Local authority,E92000001,England,E12000008,South East,921,E06000046,Isle of Wight,Total,6,4181,3733,0,62,0,32,0,30
202223,Academic year,Local authority,E92000001,England,E12000008,South East,921,E06000046,Isle of Wight,Primary,4,1330,1130,0,32,0,32,0,0
202223,Academic year,Local authority,E92000001,England,E12000008,South East,921,E06000046,Isle of Wight,Secondary,2,2851,2603,0,30,0,0,0,30
202223,Academic year,Local authority,E92000001,England,E12000008,South East,931,E10000025,Oxfordshire,Total,12,11644,10614,12,183,0,57,12,126
202223,Academic year,Local authority,E92000001,England,E12000008,South East,931,E10000025,Oxfordshire,Primary,5,1785,1474,0,57,0,57,0,0
202223,Academic year,Local authority,E92000001,England,E12000008,South East,931,E10000025,Oxfordshire,Secondary,7,9859,9140,12,126,0,0,12,126
202223,Academic year,Local authority,E92000001,England,E12000008,South East,936,E10000030,Surrey,Total,52,32846,30330,907,0,603,0,304,0
202223,Academic year,Local authority,E92000001,England,E12000008,South East,936,E10000030,Surrey,Primary,37,13633,12590,603,0,603,0,0,0
202223,Academic year,Local authority,E92000001,England,E12000008,South East,936,E10000030,Surrey,Secondary,15,19213,17740,304,0,0,0,304,0
202223,Academic year,Local authority,E92000001,England,E12000008,South East,938,E10000032,West Sussex,Total,25,21109,19221,44,349,0,219,44,130
202223,Academic year,Local authority,E92000001,England,E12000008,South East,938,E10000032,West Sussex,Primary,16,7579,6988,0,219,0,219,0,0
202223,Academic year,Local authority,E92000001,England,E12000008,South East,938,E10000032,West Sussex,Secondary,9,13530,12233,44,130,0,0,44,130
202223,Academic year,Regional,E92000001,England,E12000009,South West,,,,Total,144,101103,87973,1114,1221,576,794,538,427
202223,Academic year,Regional,E92000001,England,E12000009,South West,,,,Primary,88,32480,28467,576,768,576,768,0,0
202223,Academic year,Regional,E92000001,England,E12000009,South West,,,,Secondary,56,68623,59506,538,453,0,26,538,427
202223,Academic year,Local authority,E92000001,England,E12000009,South West,800,E06000022,Bath and North East Somerset,Total,5,3094,2441,29,56,29,26,0,30
202223,Academic year,Local authority,E92000001,England,E12000009,South West,800,E06000022,Bath and North East Somerset,Primary,3,1365,944,29,26,29,26,0,0
202223,Academic year,Local authority,E92000001,England,E12000009,South West,800,E06000022,Bath and North East Somerset,Secondary,2,1729,1497,0,30,0,0,0,30
202223,Academic year,Local authority,E92000001,England,E12000009,South West,801,E06000023,"Bristol, City of",Total,13,8828,8321,300,0,158,0,142,0
202223,Academic year,Local authority,E92000001,England,E12000009,South West,801,E06000023,"Bristol, City of",Primary,8,3150,2771,158,0,158,0,0,0
202223,Academic year,Local authority,E92000001,England,E12000009,South West,801,E06000023,"Bristol, City of",Secondary,5,5678,5550,142,0,0,0,142,0
202223,Academic year,Local authority,E92000001,England,E12000009,South West,802,E06000024,North Somerset,Total,8,6657,6275,50,51,30,41,20,10
202223,Academic year,Local authority,E92000001,England,E12000009,South West,802,E06000024,North Somerset,Primary,5,2160,1999,30,41,30,41,0,0
202223,Academic year,Local authority,E92000001,England,E12000009,South West,802,E06000024,North Somerset,Secondary,3,4497,4276,20,10,0,0,20,10
202223,Academic year,Local authority,E92000001,England,E12000009,South West,803,E06000025,South Gloucestershire,Total,10,7661,6220,30,120,12,54,18,66
202223,Academic year,Local authority,E92000001,England,E12000009,South West,803,E06000025,South Gloucestershire,Primary,5,1715,1764,12,54,12,54,0,0
202223,Academic year,Local authority,E92000001,England,E12000009,South West,803,E06000025,South Gloucestershire,Secondary,5,5946,4456,18,66,0,0,18,66
202223,Academic year,Local authority,E92000001,England,E12000009,South West,838,E06000059,Dorset,Total,11,7897,7023,0,131,0,70,0,61
202223,Academic year,Local authority,E92000001,England,E12000009,South West,838,E06000059,Dorset,Primary,5,1680,1435,0,56,0,56,0,0
202223,Academic year,Local authority,E92000001,England,E12000009,South West,838,E06000059,Dorset,Secondary,6,6217,5588,0,75,0,14,0,61
202223,Academic year,Local authority,E92000001,England,E12000009,South West,839,E06000058,"Bournemouth, Christchurch and Poole",Total,8,7166,6627,96,0,20,0,76,0
202223,Academic year,Local authority,E92000001,England,E12000009,South West,839,E06000058,"Bournemouth, Christchurch and Poole",Primary,2,930,958,20,0,20,0,0,0
202223,Academic year,Local authority,E92000001,England,E12000009,South West,839,E06000058,"Bournemouth, Christchurch and Poole",Secondary,6,6236,5669,76,0,0,0,76,0
202223,Academic year,Local authority,E92000001,England,E12000009,South West,865,E06000054,Wiltshire,Total,21,6527,5293,0,396,0,396,0,0
202223,Academic year,Local authority,E92000001,England,E12000009,South West,865,E06000054,Wiltshire,Primary,21,6527,5293,0,396,0,396,0,0
202223,Academic year,Local authority,E92000001,England,E12000009,South West,866,E06000030,Swindon,Total,12,9982,9306,57,172,10,82,47,90
202223,Academic year,Local authority,E92000001,England,E12000009,South West,866,E06000030,Swindon,Primary,7,3008,2712,10,82,10,82,0,0
202223,Academic year,Local authority,E92000001,England,E12000009,South West,866,E06000030,Swindon,Secondary,5,6974,6594,47,90,0,0,47,90
202223,Academic year,Local authority,E92000001,England,E12000009,South West,878,E10000008,Devon,Total,11,8699,6596,14,72,6,48,8,24
202223,Academic year,Local authority,E92000001,England,E12000009,South West,878,E10000008,Devon,Primary,7,2965,2517,6,48,6,48,0,0
202223,Academic year,Local authority,E92000001,England,E12000009,South West,878,E10000008,Devon,Secondary,4,5734,4079,8,24,0,0,8,24
202223,Academic year,Local authority,E92000001,England,E12000009,South West,879,E06000026,Plymouth,Total,7,6015,4980,94,0,58,0,36,0
202223,Academic year,Local authority,E92000001,England,E12000009,South West,879,E06000026,Plymouth,Primary,4,1785,1494,58,0,58,0,0,0
202223,Academic year,Local authority,E92000001,England,E12000009,South West,879,E06000026,Plymouth,Secondary,3,4230,3486,36,0,0,0,36,0
202223,Academic year,Local authority,E92000001,England,E12000009,South West,880,E06000027,Torbay,Total,6,5815,4995,0,92,0,34,0,58
202223,Academic year,Local authority,E92000001,England,E12000009,South West,880,E06000027,Torbay,Primary,3,1365,1300,0,34,0,34,0,0
202223,Academic year,Local authority,E92000001,England,E12000009,South West,880,E06000027,Torbay,Secondary,3,4450,3695,0,58,0,0,0,58
202223,Academic year,Local authority,E92000001,England,E12000009,South West,908,E06000052,Cornwall,Total,17,12815,11468,308,0,119,0,189,0
202223,Academic year,Local authority,E92000001,England,E12000009,South West,908,E06000052,Cornwall,Primary,9,3220,2780,119,0,119,0,0,0
202223,Academic year,Local authority,E92000001,England,E12000009,South West,908,E06000052,Cornwall,Secondary,8,9595,8688,189,0,0,0,189,0
202223,Academic year,Local authority,E92000001,England,E12000009,South West,916,E10000013,Gloucestershire,Total,6,2005,1443,70,10,70,0,0,10
202223,Academic year,Local authority,E92000001,England,E12000009,South West,916,E10000013,Gloucestershire,Primary,5,910,833,70,0,70,0,0,0
202223,Academic year,Local authority,E92000001,England,E12000009,South West,916,E10000013,Gloucestershire,Secondary,1,1095,610,0,10,0,0,0,10
202223,Academic year,Local authority,E92000001,England,E12000009,South West,933,E06000066,Somerset,Total,9,7942,6985,66,121,64,43,2,78
202223,Academic year,Local authority,E92000001,England,E12000009,South West,933,E06000066,Somerset,Primary,4,1700,1667,64,31,64,31,0,0
202223,Academic year,Local authority,E92000001,England,E12000009,South West,933,E06000066,Somerset,Secondary,5,6242,5318,2,90,0,12,2,78
202223,Academic year,Regional,E92000001,England,E13000001,Inner London,,,,Total,94,68731,57686,399,1458,188,1004,211,454
202223,Academic year,Regional,E92000001,England,E13000001,Inner London,,,,Primary,65,29188,23123,188,993,188,993,0,0
202223,Academic year,Regional,E92000001,England,E13000001,Inner London,,,,Secondary,29,39543,34563,211,465,0,11,211,454
202223,Academic year,Local authority,E92000001,England,E13000001,Inner London,202,E09000007,Camden,Total,9,6449,5506,300,0,89,0,211,0
202223,Academic year,Local authority,E92000001,England,E13000001,Inner London,202,E09000007,Camden,Primary,6,2106,1948,89,0,89,0,0,0
202223,Academic year,Local authority,E92000001,England,E13000001,Inner London,202,E09000007,Camden,Secondary,3,4343,3558,211,0,0,0,211,0
202223,Academic year,Local authority,E92000001,England,E13000001,Inner London,204,E09000012,Hackney,Total,9,5852,4719,0,105,0,78,0,27
202223,Academic year,Local authority,E92000001,England,E13000001,Inner London,204,E09000012,Hackney,Primary,7,3292,2241,0,78,0,78,0,0
202223,Academic year,Local authority,E92000001,England,E13000001,Inner London,204,E09000012,Hackney,Secondary,2,2560,2478,0,27,0,0,0,27
202223,Academic year,Local authority,E92000001,England,E13000001,Inner London,205,E09000013,Hammersmith and Fulham,Total,1,210,202,11,0,11,0,0,0
202223,Academic year,Local authority,E92000001,England,E13000001,Inner London,205,E09000013,Hammersmith and Fulham,Primary,1,210,202,11,0,11,0,0,0
202223,Academic year,Local authority,E92000001,England,E13000001,Inner London,206,E09000019,Islington,Total,1,350,284,64,0,64,0,0,0
202223,Academic year,Local authority,E92000001,England,E13000001,Inner London,206,E09000019,Islington,Primary,1,350,284,64,0,64,0,0,0
202223,Academic year,Local authority,E92000001,England,E13000001,Inner London,207,E09000020,Kensington and Chelsea,Total,6,4152,4004,0,91,0,52,0,39
202223,Academic year,Local authority,E92000001,England,E13000001,Inner London,207,E09000020,Kensington and Chelsea,Primary,3,1190,921,0,52,0,52,0,0
202223,Academic year,Local authority,E92000001,England,E13000001,Inner London,207,E09000020,Kensington and Chelsea,Secondary,3,2962,3083,0,39,0,0,0,39
202223,Academic year,Local authority,E92000001,England,E13000001,Inner London,208,E09000022,Lambeth,Total,10,7143,5799,0,285,0,225,0,60
202223,Academic year,Local authority,E92000001,England,E13000001,Inner London,208,E09000022,Lambeth,Primary,7,3433,2312,0,225,0,225,0,0
202223,Academic year,Local authority,E92000001,England,E13000001,Inner London,208,E09000022,Lambeth,Secondary,3,3710,3487,0,60,0,0,0,60
202223,Academic year,Local authority,E92000001,England,E13000001,Inner London,209,E09000023,Lewisham,Total,12,9256,6887,0,206,0,120,0,86
202223,Academic year,Local authority,E92000001,England,E13000001,Inner London,209,E09000023,Lewisham,Primary,8,4545,3819,0,120,0,120,0,0
202223,Academic year,Local authority,E92000001,England,E13000001,Inner London,209,E09000023,Lewisham,Secondary,4,4711,3068,0,86,0,0,0,86
202223,Academic year,Local authority,E92000001,England,E13000001,Inner London,210,E09000028,Southwark,Total,6,2475,2003,24,78,24,78,0,0
202223,Academic year,Local authority,E92000001,England,E13000001,Inner London,210,E09000028,Southwark,Primary,6,2475,2003,24,78,24,78,0,0
202223,Academic year,Local authority,E92000001,England,E13000001,Inner London,211,E09000030,Tower Hamlets,Total,8,5952,5516,0,167,0,136,0,31
202223,Academic year,Local authority,E92000001,England,E13000001,Inner London,211,E09000030,Tower Hamlets,Primary,6,2645,2456,0,125,0,125,0,0
202223,Academic year,Local authority,E92000001,England,E13000001,Inner London,211,E09000030,Tower Hamlets,Secondary,2,3307,3060,0,42,0,11,0,31
202223,Academic year,Local authority,E92000001,England,E13000001,Inner London,212,E09000032,Wandsworth,Total,11,9218,7442,0,293,0,164,0,129
202223,Academic year,Local authority,E92000001,England,E13000001,Inner London,212,E09000032,Wandsworth,Primary,7,3108,2218,0,164,0,164,0,0
202223,Academic year,Local authority,E92000001,England,E13000001,Inner London,212,E09000032,Wandsworth,Secondary,4,6110,5224,0,129,0,0,0,129
202223,Academic year,Local authority,E92000001,England,E13000001,Inner London,213,E09000033,Westminster,Total,6,3442,2988,0,81,0,58,0,23
202223,Academic year,Local authority,E92000001,England,E13000001,Inner London,213,E09000033,Westminster,Primary,4,1232,825,0,58,0,58,0,0
202223,Academic year,Local authority,E92000001,England,E13000001,Inner London,213,E09000033,Westminster,Secondary,2,2210,2163,0,23,0,0,0,23
202223,Academic year,Local authority,E92000001,England,E13000001,Inner London,309,E09000014,Haringey,Total,2,810,727,0,32,0,32,0,0
202223,Academic year,Local authority,E92000001,England,E13000001,Inner London,309,E09000014,Haringey,Primary,2,810,727,0,32,0,32,0,0
202223,Academic year,Local authority,E92000001,England,E13000001,Inner London,316,E09000025,Newham,Total,13,13422,11609,0,120,0,61,0,59
202223,Academic year,Local authority,E92000001,England,E13000001,Inner London,316,E09000025,Newham,Primary,7,3792,3167,0,61,0,61,0,0
202223,Academic year,Local authority,E92000001,England,E13000001,Inner London,316,E09000025,Newham,Secondary,6,9630,8442,0,59,0,0,0,59
202223,Academic year,Regional,E92000001,England,E13000002,Outer London,,,,Total,224,192998,175301,1107,3018,851,1870,256,1148
202223,Academic year,Regional,E92000001,England,E13000002,Outer London,,,,Primary,150,80012,71296,851,1832,851,1832,0,0
202223,Academic year,Regional,E92000001,England,E13000002,Outer London,,,,Secondary,74,112986,104005,256,1186,0,38,256,1148
202223,Academic year,Local authority,E92000001,England,E13000002,Outer London,203,E09000011,Greenwich,Total,14,13271,12097,0,248,0,115,0,133
202223,Academic year,Local authority,E92000001,England,E13000002,Outer London,203,E09000011,Greenwich,Primary,8,3600,3378,0,115,0,115,0,0
202223,Academic year,Local authority,E92000001,England,E13000002,Outer London,203,E09000011,Greenwich,Secondary,6,9671,8719,0,133,0,0,0,133
202223,Academic year,Local authority,E92000001,England,E13000002,Outer London,301,E09000002,Barking and Dagenham,Total,24,27180,22411,100,282,84,150,16,132
202223,Academic year,Local authority,E92000001,England,E13000002,Outer London,301,E09000002,Barking and Dagenham,Primary,17,11435,9805,84,126,84,126,0,0
202223,Academic year,Local authority,E92000001,England,E13000002,Outer London,301,E09000002,Barking and Dagenham,Secondary,7,15745,12606,16,156,0,24,16,132
202223,Academic year,Local authority,E92000001,England,E13000002,Outer London,302,E09000003,Barnet,Total,14,9709,9357,0,273,0,172,0,101
202223,Academic year,Local authority,E92000001,England,E13000002,Outer London,302,E09000003,Barnet,Primary,10,4467,4279,0,172,0,172,0,0
202223,Academic year,Local authority,E92000001,England,E13000002,Outer London,302,E09000003,Barnet,Secondary,4,5242,5078,0,101,0,0,0,101
202223,Academic year,Local authority,E92000001,England,E13000002,Outer London,304,E09000005,Brent,Total,7,6578,5902,0,155,0,118,0,37
202223,Academic year,Local authority,E92000001,England,E13000002,Outer London,304,E09000005,Brent,Primary,5,2443,1962,0,118,0,118,0,0
202223,Academic year,Local authority,E92000001,England,E13000002,Outer London,304,E09000005,Brent,Secondary,2,4135,3940,0,37,0,0,0,37
202223,Academic year,Local authority,E92000001,England,E13000002,Outer London,305,E09000006,Bromley,Total,18,12038,11559,235,157,235,96,0,61
202223,Academic year,Local authority,E92000001,England,E13000002,Outer London,305,E09000006,Bromley,Primary,15,6837,6390,235,96,235,96,0,0
202223,Academic year,Local authority,E92000001,England,E13000002,Outer London,305,E09000006,Bromley,Secondary,3,5201,5169,0,61,0,0,0,61
202223,Academic year,Local authority,E92000001,England,E13000002,Outer London,306,E09000008,Croydon,Total,16,11525,9366,0,275,0,202,0,73
202223,Academic year,Local authority,E92000001,England,E13000002,Outer London,306,E09000008,Croydon,Primary,10,4321,3735,0,188,0,188,0,0
202223,Academic year,Local authority,E92000001,England,E13000002,Outer London,306,E09000008,Croydon,Secondary,6,7204,5631,0,87,0,14,0,73
202223,Academic year,Local authority,E92000001,England,E13000002,Outer London,307,E09000009,Ealing,Total,16,13904,13579,14,326,14,222,0,104
202223,Academic year,Local authority,E92000001,England,E13000002,Outer London,307,E09000009,Ealing,Primary,11,5829,5592,14,222,14,222,0,0
202223,Academic year,Local authority,E92000001,England,E13000002,Outer London,307,E09000009,Ealing,Secondary,5,8075,7987,0,104,0,0,0,104
202223,Academic year,Local authority,E92000001,England,E13000002,Outer London,310,E09000015,Harrow,Total,12,10707,9913,0,139,0,85,0,54
202223,Academic year,Local authority,E92000001,England,E13000002,Outer London,310,E09000015,Harrow,Primary,8,5258,4479,0,85,0,85,0,0
202223,Academic year,Local authority,E92000001,England,E13000002,Outer London,310,E09000015,Harrow,Secondary,4,5449,5434,0,54,0,0,0,54
202223,Academic year,Local authority,E92000001,England,E13000002,Outer London,311,E09000016,Havering,Total,7,5028,4813,97,24,65,24,32,0
202223,Academic year,Local authority,E92000001,England,E13000002,Outer London,311,E09000016,Havering,Primary,5,2928,2731,65,24,65,24,0,0
202223,Academic year,Local authority,E92000001,England,E13000002,Outer London,311,E09000016,Havering,Secondary,2,2100,2082,32,0,0,0,32,0
202223,Academic year,Local authority,E92000001,England,E13000002,Outer London,312,E09000017,Hillingdon,Total,13,10703,9324,0,140,0,95,0,45
202223,Academic year,Local authority,E92000001,England,E13000002,Outer London,312,E09000017,Hillingdon,Primary,9,5387,4404,0,95,0,95,0,0
202223,Academic year,Local authority,E92000001,England,E13000002,Outer London,312,E09000017,Hillingdon,Secondary,4,5316,4920,0,45,0,0,0,45
202223,Academic year,Local authority,E92000001,England,E13000002,Outer London,313,E09000018,Hounslow,Total,20,13528,12525,191,113,164,55,27,58
202223,Academic year,Local authority,E92000001,England,E13000002,Outer London,313,E09000018,Hounslow,Primary,15,7160,6415,164,55,164,55,0,0
202223,Academic year,Local authority,E92000001,England,E13000002,Outer London,313,E09000018,Hounslow,Secondary,5,6368,6110,27,58,0,0,27,58
202223,Academic year,Local authority,E92000001,England,E13000002,Outer London,314,E09000021,Kingston upon Thames,Total,15,10650,10132,0,276,0,174,0,102
202223,Academic year,Local authority,E92000001,England,E13000002,Outer London,314,E09000021,Kingston upon Thames,Primary,10,4380,3851,0,174,0,174,0,0
202223,Academic year,Local authority,E92000001,England,E13000002,Outer London,314,E09000021,Kingston upon Thames,Secondary,5,6270,6281,0,102,0,0,0,102
202223,Academic year,Local authority,E92000001,England,E13000002,Outer London,315,E09000024,Merton,Total,9,6845,6347,156,47,156,0,0,47
202223,Academic year,Local authority,E92000001,England,E13000002,Outer London,315,E09000024,Merton,Primary,6,2588,2345,156,0,156,0,0,0
202223,Academic year,Local authority,E92000001,England,E13000002,Outer London,315,E09000024,Merton,Secondary,3,4257,4002,0,47,0,0,0,47
202223,Academic year,Local authority,E92000001,England,E13000002,Outer London,317,E09000026,Redbridge,Total,7,9280,8531,151,28,35,28,116,0
202223,Academic year,Local authority,E92000001,England,E13000002,Outer London,317,E09000026,Redbridge,Primary,3,2130,1854,35,28,35,28,0,0
202223,Academic year,Local authority,E92000001,England,E13000002,Outer London,317,E09000026,Redbridge,Secondary,4,7150,6677,116,0,0,0,116,0
202223,Academic year,Local authority,E92000001,England,E13000002,Outer London,318,E09000027,Richmond upon Thames,Total,12,10450,9509,0,139,0,83,0,56
202223,Academic year,Local authority,E92000001,England,E13000002,Outer London,318,E09000027,Richmond upon Thames,Primary,7,3720,2957,0,83,0,83,0,0
202223,Academic year,Local authority,E92000001,England,E13000002,Outer London,318,E09000027,Richmond upon Thames,Secondary,5,6730,6552,0,56,0,0,0,56
202223,Academic year,Local authority,E92000001,England,E13000002,Outer London,319,E09000029,Sutton,Total,11,11638,11465,163,222,98,157,65,65
202223,Academic year,Local authority,E92000001,England,E13000002,Outer London,319,E09000029,Sutton,Primary,6,3149,3259,98,157,98,157,0,0
202223,Academic year,Local authority,E92000001,England,E13000002,Outer London,319,E09000029,Sutton,Secondary,5,8489,8206,65,65,0,0,65,65
202223,Academic year,Local authority,E92000001,England,E13000002,Outer London,320,E09000031,Waltham Forest,Total,9,9964,8471,0,174,0,94,0,80
202223,Academic year,Local authority,E92000001,England,E13000002,Outer London,320,E09000031,Waltham Forest,Primary,5,4380,3860,0,94,0,94,0,0
202223,Academic year,Local authority,E92000001,England,E13000002,Outer London,320,E09000031,Waltham Forest,Secondary,4,5584,4611,0,80,0,0,0,80
